###############$################
#         #                    #
# ### ######################## #
# # ###       #   #          # #
# #     ##### ### # ######## # #
# ### ### # #  #  # #      # # #
#   # # # #   ###   # # ## # # #
# # ### # ## ######## # ##   # #
# # ### #  # #   #    #    ### #
# # # # ## # #   # ####### # # #
# #        # #   #     #     # #
# ######## # ## ###### # ### # #
# # #      #  # #   #  # # # # #
# # #### #### # # # # ## # # # #
#   #       # # # # #  #     # #
# ### ## #### # # #### ##### # #
# # ###  #  # # # #        # # #
# # ### ### # # # # # #### # # #
# #     ### # # # # # #    # # #
# # # # # # # # # # ######## # #
# # # #     #     #    #     # #
# ### ################ # # # # #
# #   #              # # #   # #
# # #### ############# # # # # #
# #                    #     # #
# # #### ############### # # # #
# #  # # #   #       ###     # #
# # ## # ### ### ### ### # ### #
# #          #   #   # # #   # #
# ################## # ### ### #
#                      #       #
############# ##################