#########################
$ #######################
# #######################
#                       #
####################### #
#                       #
# #######################
#                       #
################## ######